WWWWWWWWWWWWWWWWWWWWWWWWWWWWWWWWWWWWWWWW
W.....................................EW
W......................................W
W......................................W
W......................................W
W......................................W
W......................................W
W......................................W
W......................................W
W......................................W
W......................................W
W......................................W
W......................................W
W......................................W
W......................................W
W......................................W
W......................................W
W......................................W
W......................................W
W......................................W
W......................................W
W......................................W
W......................................W
W......................................W
W......................................W
W......................................W
WWWWWWWWWWWWWWWWWWWWWWWWWWWWWWWWWWWWWWWW