WWWWWWWWWWWWWWWWWWWWWWWWWWWWWWWWWWWWWWWW
W...................................w..W
W......................................W
W..................................W...W
W...6.........w............W...........W
W......................................W
W......................................W
W......................................W
W......................................W
W......................................W
W......................................W
W......................................W
W......................................W
W......................................W
W......................................W
W......................................W
W......................................W
W......................................W
W......................................W
W......................................W
W......................................W
W......................................W
W......................................W
W......................................W
W......................................W
W......................................W
WWWWWWWWWWWWWWWWWWWWWWWWWWWWWWWWWWWWWWWW