002220000000000000000002222000
010000000000000000000000000100
01P000000000000000000000000100
010000000000000000000000000100
010000000000000000000000000100
010000000000000000000000000100
010000000000000000000000000100
010000000000000000000000000100
010000000000000000000000000100
010000000000000000000000000100
010000000000000000000000000100
002220000000000000000000022000
000000000000000000000000000000
000000000000000000000000000000
000000000000000000000000000000
000000000000000000000000000000
000000000000000000000000000000
000000000000000000000000000000
000000000000000000000000000000
000000000000000000000000000000
