002220000000000000000002222000
010000000000000000000000000100
010000000000000000000000000100
010000000000000000000000000100
010000000000000000000000222000
01000000000000H000000000000100
010000000000000000000000000100
010000000000000000000000000100
01000000000000000000V000000100
010000000000000000000000000100
010000000000000000000000000100
002220000000000000000000022000
000000000000000000000000000000
000000000000000000000000000000
000000000000000000000000000000
000000000000000000000000000000
000000000000000000000000000000
000000000000000000000000000000
000000000000000000000000000000
000000000000000000000000000000
