00WWW000000000000000000WWWW000
0W0000000000000000000000000W00
0W0000000000000000000000000W00
0W0000000000000000000000000W00
0W0000000000000000000000WWW000
0W000000000000H000000000000W00
0W0000000000000000000000000W00
0W0000000000000000000000000W00
0W000000000000000000V000000W00
0W0000000000000000000000000W00
0W0000000000000000000000000W00
00WWW00000000000000000000WW000
000000000000000000000000000000
000000000000000000000000000000
000000000000000000000000000000
000000000000000000000000000000
000000000000000000000000000000
000000000000000000000000000000
000000000000000000000000000000
000000000000000000000000000000
